NO   ./texture/colorstone.png      
SO   ./texture/redbrick.png          






EA   ./texture/mossy.png





C 0,25,25
WE ./texture/wood.png
F 255,255,255

1111
11N	1
1111
		
