NO   ./texture/colorstone.png      
SO   ./texture/redbrick.png          
WE   ./texture/wood.png
EA   ./texture/mossy.png

F   220,100,0
C   255,255,255 

11111111111111111111111111
10000000000000000000000001
100000000000DDD00000000001
1000000000000N000000000001
10000000000000000000000001
1000000000000000D000000001
10000000000000000000000001
11111111111111111111111111





