NO   ./texture/test1.png  
SO   ./texture/test1.png        






EA   ./texture/test1.png





C 0,25,25
WE ./texture/moon.png
F 255,255,255

11111
1W001                       
10D01
10001
11111		
