NO   ./texture/colorstone.png      
SO   ./texture/redbrick.png          







EA   ./texture/mossy.png





F 90,20,10

WE   ./texture/wood.png


C 0,0,0



11111111111111111111111111111111111111111111111
10000000000000000000000001
100000000000DDD00000000001
1000000000000N000000000001
10000000000000000010000001
1000000000000000D000000001
100000000000000111111110001
111111111111111       11111111








