NO   ./texture/path_to_the_north_texture      
SO   ./texture/path_to_the_south_texture           
WE   ./texture/path_to_the_west_texture      
EA   ./texture/path_to_the_east_texture

F   220,100,0
C   225,30,0 

11111111111111111111111111
10000000000000000000000101
10000100000000000000000001
1000000000000N000100000001
10000000000000000100000001
10000010000000000100000001
10000000000000000000000001
11111111111111111111111111
