NO   ./texture/colorstone.png      
SO   ./texture/redbrick.png          







EA   ./texture/mossy.png





C 0,0,0

WE   ./texture/wood.png


F 255,255,255



11111111111111111111111111
10000000000000000000000001
100000000000DDD00000000001
1000000000000N000100000001
10000000000000000010000001
1000000000000000D000000001
100000000000000111111110001
111111111111111       11111








