



      NO                  ./texture/path_to_the_north_texture      
SO                     ./texture/path_to_the_south_texture           

             WE        ./texture/path_to_the_west_texture      

EA ./texture/path_to_the_east_texture

                 F                              220          ,100,               0

     C                  225                  ,30,0 

            111111111111111111111111
11110111111111011100000010001
11110111111111011101010010001
                        11101
11000001110101011111011100N0111
11110111 1110101 101111010001
11111111 1111111111111111111

            

